
SO assets/south.xpm
NO assets/north.xpm
WE assets/west.xpm
EA assets/east.xpm
                         

            C       17, 216 , 230
F 105,105,105
         
                  
1111111111
1000000011
1000110001
10000E0001
1111111111
