
SO assets/south.xpm
NO assets/north.xpm      
C       17, 216 , 230
WE assets/west.xpm
EA assets/east.xpm
                         
F 105,105,105

                  
11111111 1111
1000000011
1000110001
10000E0001
1111111111
