
F 105,105,105
SO assets/south.xpm
NO assets/north.xpm      
C       17, 216 , 230
WE assets/west.xpm
EA assets/east.xpm
                         
1111111111
1000000011   
1000110001
10000E0001
11111111111



